________
__0__00_
__A__B__
_0__0___
_0_0__0_
__D__C__
_00__0__
________