__A_____
_00__00_
_0___B0_
___00___
___00___
_0___C0_
_00__00_
_______D