__________
_0______0_
_0____B_0_
A___00____
0__0000__0
____00____
_0____C_0_
_0______0_
________D_