__B__0___
_0_0___0_
___0_000_
0________
0_0000___
_________
___0000_0
________0
_000_0___
_0___0_0_
A__0_____