___B_____
__0______
__0__00__
0____0___
0_0_00___
_________
___00_0_0
___0____0
__00__0__
______0__
A________